
ParamBindings(
    mCallerToCalleeMap: CallHandle	 => std::map<ProcHandle, std::map<MemRefHandle, SymHandle> > 
            CallHandle(sub1_(&R:0:.predef_F8, &A:0:.predef_F8, &C:0:.predef_F8))	 => 
            second: ProcHandle	 => std::map<MemRefHandle, SymHandle> 
                    ProcHandle(sub1_)	 => 
                    second: MemRefHandle	 => SymHandle
                            MemRefHandle(R:0:.predef_F8)	 => SymHandle(RADIUS)
                            MemRefHandle(A:0:.predef_F8)	 => SymHandle(AREA)
                            MemRefHandle(C:0:.predef_F8)	 => SymHandle(CIRCUM)



    mCalleeToCallerMap: CallHandle	 => std::map<SymHandle, MemRefHandle> 
            CallHandle(sub1_(&R:0:.predef_F8, &A:0:.predef_F8, &C:0:.predef_F8))	 => 
            second: SymHandle	 => MemRefHandle
                    SymHandle(RADIUS)	 => MemRefHandle(R:0:.predef_F8)
                    SymHandle(AREA)	 => MemRefHandle(A:0:.predef_F8)
                    SymHandle(CIRCUM)	 => MemRefHandle(C:0:.predef_F8)


    mProcToFormalSetMap: ProcHandle	 => OA_ptr<std::set<SymHandle> >
            ProcHandle(sub1_)	 => [ SymHandle(RADIUS)    SymHandle(AREA)    SymHandle(CIRCUM) ] 

    mCallToActualSetMap: CallHandle	 => OA_ptr<std::set<MemRefHandle> >
            CallHandle(sub1_(&R:0:.predef_F8, &A:0:.predef_F8, &C:0:.predef_F8))	 => [ MemRefHandle(R:0:.predef_F8)    MemRefHandle(A:0:.predef_F8)    MemRefHandle(C:0:.predef_F8) ] 

)
