 LOC 0 0 source files:	1	"/s/parsons/b/others/malusare/UseOA-Open64/TestCases/ParamBinding/stat_selection.f90"
I8SRCTRIPLET
I8SRCTRIPLET
I8SRCTRIPLET

ParamBindings(
    mCallerToCalleeMap: CallHandle	 => std::map<ProcHandle, std::map<MemRefHandle, SymHandle> > 
            CallHandle(stats_(&0:X:0:anon_ptr., &N:0:.predef_I4, &M:0:.predef_F4, &SD:0:.predef_F4, &MEDIAN:0:.predef_F4))	 => 
            second: ProcHandle	 => std::map<MemRefHandle, SymHandle> 
                    ProcHandle(stats_)	 => 
                    second: MemRefHandle	 => SymHandle
                            MemRefHandle(0:X:0:anon_ptr.)	 => SymHandle(X)
                            MemRefHandle(N:0:.predef_I4)	 => SymHandle(N)
                            MemRefHandle(M:0:.predef_F4)	 => SymHandle(MEAN)
                            MemRefHandle(SD:0:.predef_F4)	 => SymHandle(STD_DEV)
                            MemRefHandle(MEDIAN:0:.predef_F4)	 => SymHandle(MEDIAN)
    mCalleeToCallerMap: CallHandle	 => std::map<SymHandle, MemRefHandle> 
            CallHandle(stats_(&0:X:0:anon_ptr., &N:0:.predef_I4, &M:0:.predef_F4, &SD:0:.predef_F4, &MEDIAN:0:.predef_F4))	 => 
            second: SymHandle	 => MemRefHandle
                    SymHandle(N)	 => MemRefHandle(N:0:.predef_I4)
                    SymHandle(X)	 => MemRefHandle(0:X:0:anon_ptr.)
                    SymHandle(MEAN)	 => MemRefHandle(M:0:.predef_F4)
                    SymHandle(STD_DEV)	 => MemRefHandle(SD:0:.predef_F4)
                    SymHandle(MEDIAN)	 => MemRefHandle(MEDIAN:0:.predef_F4)
    mProcToFormalSetMap: ProcHandle	 => OA_ptr<std::set<SymHandle> >
            ProcHandle(stats_)	 => [ SymHandle(N)    SymHandle(X)    SymHandle(MEAN)    SymHandle(STD_DEV)    SymHandle(MEDIAN) ] 
            ProcHandle(SELECTION)	 => [ SymHandle(N) ] 
    mCallToActualSetMap: CallHandle	 => OA_ptr<std::set<MemRefHandle> >
            CallHandle(stats_(&0:X:0:anon_ptr., &N:0:.predef_I4, &M:0:.predef_F4, &SD:0:.predef_F4, &MEDIAN:0:.predef_F4))	 => [ MemRefHandle(0:X:0:anon_ptr.)    MemRefHandle(N:0:.predef_I4)    MemRefHandle(M:0:.predef_F4)    MemRefHandle(SD:0:.predef_F4)    MemRefHandle(MEDIAN:0:.predef_F4) ] 
)
